1111111111111111
10CCC010C0010001
1000CC0000000001
1000010011111001
1000010000010001
100C000E00111001
100P000110001C01
1111111111111111