11111111111111111111
1CCC0000000C00000001
1CCXC00000CCC0000001
100C0000000C00000001
10000CCC00000X00CC01
100000000000C0000001
10000000000CCC000001
1000CC0000X0C0000001
1000CC00000000000001
1000CC00E00000000001
10000000000C00000001
10000000000C00000001
100C0000000000C0C001
10CXC000000000000001
100C0000000000000P01
11111111111111111111
