1111111111111111111
100000000000C000X01
1011011101011101101
1X11011101011101101
1001000000000001001
1101010111110101X11
1000010001000100001
1011111101011111101
1000000000000000001
1011100110110011101
111X1001C0P10X1C101
11E000011111000X101
1110100000000010101
10111001111100111X1
100000000100000C001
1011011101011101101
10C1000000C000X1001
1101010111110101011
10X0010C01000100001
1011111101011111101
1X000000000000000C1
1111111111111111111
